111111111111111111111111111111111
1...............................1
1...............................1
1...............................1
1...............................1
1...............................1
12222222222222..................1
1...............................1
1...............................1
1...............................1
1...............................1
1......11111111122222222222222221
1......1........................1
1....111.........1..............1
1....1.........1.1.1............1
1..1.1.......1.1.1.1.1..........1
1..1.1.....1.1.1.1.1.1.1........1
111111111111111111111111111111111
