111111111111111111111111111111111111111111111111
1..............................................1
1..............................................1
1..............................................1
1..............................................1
1..............................................1
12222222222222.................................1
1..............................................1
1..............................................1
1..............................................1
1.....................3333333333m333333333333331
1........222222222222211111111122222222222222221
1..............................................1
1..............................................1
12222222222222.................................1
1..............................................1
1..............................................1
1..............................................1
1...............................2222222222222221
1..............................................1
1..............22222222222222..................1
1..............................................1
12222222222222.................................1
1..............................................1
1..............................................1
1..............................................1
1..............................................1
1......1.......................................1
1....111........................1..............1
1....1........................1.1.1............1
1..1.1......................1.1.1.1.1..........1
1..1.1....................1.1.1.1.1.1.1m33333331
111111111111111111111111111111111111111111111111