111111111111111111111111111111111111111111111111
1..............................................1
1..............................................1
1..............................................1
1..............................................1
1..............................................1
12222222222222.................................1
1..............................................1
1..............................................1
1........4..................d..................1
1.....................333333333333333m3333333331
1........222222222222211111111122222222222222221
1..............................................1
1...................222222.....................1
12222222222222.................................1
1..................................22222.......1
1..............................................1
1..............................................1
1...............................2222222222222221
1..............................................1
1..............22222222222222..................1
1..............................................1
12222222222222.................................1
1..............................................1
1..............................................1
1..............................................1
1..............................................1
1......1.......................................1
1....111........................1..............1
1....1d.......................1.1.1............1
1..1.1........0.............1.1.1.1.1..........1
1m31.1.................3331.1.1.1.1.1.1333333331
111111111111111111111111111111111111111111111111
wall_background
soundtrack_1.wav