111111111111111111111111111111111111111111111111
1111111111111111111..........1111111111111111111
11............................................11
1..............................................1
1..............................................1
1......................4.......................1
1..................................22222.......1
1...................1111111111.................1
1..........................................22221
1..............................................1
1......................................2222....1
1..............................................1
1..............................2222............1
11............2222............................11
11............................................11
11222.........................................11
111..........................................111
111.....222..................................111
1111........................................1111
111122222222222222222222222222222222222222221111
11111......................................11111
11111......................................11111
111111....................................111111
1111111..................................1111111
11111111................................11111111
111111111..............................111111111
1111111111m3........................m31111111111
111111111111........................111111111111
11111111111111m3................m311111111111111
1111111111111111................1111111111111111
11111111111111111113333m333331111111111111111111
111111111111111111111111111111111111111111111111